root	/root	/bin/bash
bin	/bin	/usr/bin/nologin
daemon	/	/usr/bin/nologin
mail	/var/spool/mail	/usr/bin/nologin
ftp	/srv/ftp	/usr/bin/nologin
http	/srv/http	/usr/bin/nologin
uuidd	/	/usr/bin/nologin
dbus	/	/usr/bin/nologin
nobody	/	/usr/bin/nologin
systemd-journal-gateway	/	/usr/bin/nologin
systemd-timesync	/	/usr/bin/nologin
systemd-network	/	/usr/bin/nologin
systemd-bus-proxy	/	/usr/bin/nologin
systemd-resolve	/	/usr/bin/nologin
systemd-coredump	/	/sbin/nologin
systemd-journal-remote	/	/sbin/nologin
systemd-journal-upload	/	/sbin/nologin
polkitd	/	/usr/bin/nologin
avahi	/	/bin/nologin
rtkit	/proc	/bin/false
colord	/var/lib/colord	/bin/false
lightdm	/var/lib/lightdm	/usr/bin/nologin
nm-openvpn	/	/usr/bin/nologin
rpc	/dev/null	/bin/false
git	/home/git	/bin/bash
compro	/home/compro	/bin/bash
mysql	/var/lib/mysql	/sbin/nologin
usbmux	/	/sbin/nologin
deepin-daemon	/	/sbin/nologin
ceph	/run/ceph	/sbin/nologin
redis	/var/lib/redis	/bin/false
gitlab	/var/lib/gitlab	/usr/share/webapps/gitlab-shell/bin/gitlab-shell
gitlab-runner	/var/lib/gitlab-runner	/sbin/nologin
guixbuilder01	/var/empty	/usr/bin/nologin
guixbuilder02	/var/empty	/usr/bin/nologin
guixbuilder03	/var/empty	/usr/bin/nologin
guixbuilder04	/var/empty	/usr/bin/nologin
guixbuilder05	/var/empty	/usr/bin/nologin
guixbuilder06	/var/empty	/usr/bin/nologin
guixbuilder07	/var/empty	/usr/bin/nologin
guixbuilder08	/var/empty	/usr/bin/nologin
guixbuilder09	/var/empty	/usr/bin/nologin
guixbuilder10	/var/empty	/usr/bin/nologin
postfix	/var/spool/postfix	/bin/false
fetchmail	/var/lib/fetchmail	/sbin/nologin
tor	/var/lib/tor	/bin/false
unbound	/etc/unbound	/bin/false
monero	/var/lib/monero	/bin/bash
dnsmasq	/	/sbin/nologin
cups	/	/sbin/nologin
